{
  "name": "Level Debug",
  "tileSize": 64,
  "background": [
    [1, 1, 4, 0, 3, 0, 0, 0, 2, 0, 0, 0, 0, 0, 0],
    [0, 0, 5, 1, 4, 0, 0, 0, 0, 0, 0, 3, 0, 0, 0],
    [0, 0, 0, 0, 5, 4, 0, 0, 0, 3, 0, 0, 0, 0, 0],
    [0, 0, 0, 0, 0, 5, 4, 0, 0, 0, 0, 0, 0, 3, 0],
    [0, 0, 3, 0, 0, 0, 6, 0, 0, 0, 0, 0, 2, 0, 0],
    [0, 0, 0, 0, 0, 0, 6, 0, 0, 0, 2, 0, 0, 0, 0],
    [0, 0, 3, 0, 0, 0, 6, 0, 0, 0, 0, 0, 3, 0, 0],
    [0, 3, 0, 2, 0, 0, 5, 1, 1, 4, 0, 0, 0, 0, 3],
    [0, 0, 0, 0, 3, 0, 0, 0, 0, 5, 1, 1, 4, 0, 0],
    [0, 0, 2, 0, 0, 0, 0, 2, 0, 0, 0, 0, 5, 1, 1]
  ],
  "foreground": [
    [0, 0, 0, 1, 1, 1, 0, 0, 0, 0, 0, 0, 0, 0, 0],
    [0, 0, 0, 0, 0, 0, 0, 0, 0, 0, 0, 0, 0, 0, 0],
    [0, 0, 0, 0, 0, 0, 0, 0, 0, 0, 0, 0, 0, 0, 0],
    [0, 0, 0, 0, 0, 0, 0, 0, 0, 0, 0, 0, 0, 0, 0],
    [0, 0, 0, 0, 0, 0, 0, 0, 0, 0, 0, 0, 0, 0, 0],
    [0, 0, 0, 0, 0, 0, 0, 0, 0, 0, 0, 0, 0, 0, 0],
    [0, 0, 0, 0, 0, 0, 0, 0, 0, 0, 0, 0, 0, 0, 0],
    [0, 0, 0, 0, 0, 0, 0, 0, 0, 0, 0, 0, 0, 0, 0],
    [0, 0, 0, 0, 0, 0, 0, 0, 1, 0, 0, 0, 0, 0, 0],
    [0, 0, 0, 0, 0, 0, 0, 0, 0, 1, 1, 1, 0, 0, 0]
  ],
  "paths": [
    [0, 0],
    [0, 3],
    [1, 3],
    [1, 5],
    [2, 5],
    [2, 6],
    [3, 6],
    [3, 7],
    [7, 6],
    [7, 9],
    [8, 9],
    [9, 11],
    [9, 14]
  ]
}
